35 35 35 35 35 35 35 35 35 35 35 35 35 35 35 35 35 35 35 35 35
186 186 186 186 186 186 186 186 186 186 186 186 186 186 186 186 186 186 186 186 186
186 186 186 186 186 186 186 186 186 186 186 186 186 186 186 186 186 186 186 186 186
186 186 186 186 186 186 186 186 186 186 186 186 186 186 186 186 186 186 186 186 186
186 186 186 186 186 186 186 186 186 186 186 186 186 186 186 186 186 186 186 186 186
186 186 186 186 186 186 186 186 186 186 186 186 186 186 186 186 186 186 186 186 186
186 186 186 186 186 186 186 186 186 186 186 186 186 186 186 186 186 186 186 0 140
186 186 186 186 186 186 186 186 186 186 186 186 186 186 186 186 1 1 186 17 140
186 186 186 186 186 186 186 186 186 186 186 186 186 186 186 186 186 186 186 17 140
186 186 186 186 186 186 186 186 186 186 186 186 186 1 1 186 186 186 186 17 140
186 186 186 186 186 186 186 186 186 186 186 186 186 186 186 186 186 186 186 17 140
186 186 186 186 186 186 186 186 1 1 1 1 1 1 1 1 2 186 186 17 140
186 186 186 186 186 0 1 1 70 70 70 70 70 70 70 71 19 186 186 17 140
186 186 186 186 186 17 70 71 71 71 71 70 70 70 71 71 19 186 186 17 140
186 186 0 1 1 70 71 71 71 71 71 71 70 70 71 71 19 186 186 17 140
186 186 17 70 70 70 70 70 70 70 70 70 70 70 70 71 19 186 186 17 140
