21 186 23 35 35 35 35 35 35 35 35 35 35 35 35 35 35 35 35 35 35
21 186 23 186 186 186 186 186 186 186 186 186 186 186 186 186 186 186 186 186 186
38 39 40 186 186 186 186 186 186 186 186 186 186 186 186 186 186 186 186 186 186
186 186 186 186 186 186 186 186 186 186 186 186 186 186 186 186 186 186 186 186 186
186 186 186 186 186 186 186 186 186 186 186 186 186 186 186 186 186 186 186 186 186
186 186 186 186 186 186 186 186 186 186 186 186 186 186 186 186 186 186 186 186 186
186 186 186 186 186 186 186 186 186 186 186 186 186 186 186 186 186 186 186 186 186
186 186 186 186 186 186 186 186 186 186 186 186 186 1 1 1 1 1 186 186 186
186 186 186 186 186 186 186 186 186 186 186 186 186 186 186 186 186 186 186 186 186
186 186 186 186 186 186 186 186 186 186 5 186 186 186 186 186 186 186 186 186 186
186 186 186 186 186 186 186 186 186 186 186 186 186 186 186 186 186 186 186 186 186
186 186 186 186 186 186 186 5 5 186 186 186 186 186 5 186 186 186 186 186 186
186 186 186 186 186 5 186 186 186 186 186 186 186 186 186 186 186 186 186 186 186
186 1 186 0 186 186 186 186 186 2 186 186 5 186 186 186 4 5 5 6 186
186 186 186 17 1 1 1 1 1 19 186 186 186 186 186 186 21 106 107 23 186
186 186 186 17 70 70 70 70 71 19 186 186 186 186 186 186 21 123 124 23 186
