39 39 39 39 39 39 39 39 39 39 39 39 39 39 39 39 39 39 39 39 39 39 39 39
186 186 186 186 186 186 186 186 186 186 186 186 186 186 186 186 186 12 13 186 186 186 186 186
186 186 186 186 186 186 186 186 186 186 186 186 186 186 186 186 186 186 186 186 186 186 186 186
186 186 186 186 186 186 186 186 186 186 186 186 186 186 186 186 186 186 186 186 186 186 186 186
186 186 186 186 186 186 186 186 186 186 186 186 186 186 186 186 186 186 186 186 186 186 186 186
186 186 186 186 186 186 186 186 186 186 186 186 186 186 186 186 186 186 186 186 186 186 186 186
186 186 186 186 186 186 186 186 186 186 186 186 186 186 186 186 186 186 186 186 186 186 186 186
186 186 186 186 186 186 186 186 186 186 186 186 186 186 186 186 186 5 5 186 186 186 186 186
186 186 186 186 186 186 186 186 186 186 186 186 186 186 5 5 186 186 186 186 186 186 186 186
186 186 186 186 186 186 186 186 186 186 186 186 186 186 186 186 186 186 186 186 186 186 186 186
186 186 186 186 186 186 186 186 186 186 186 5 186 186 186 186 186 186 186 186 186 186 186 186
186 186 186 186 186 186 186 186 186 186 186 186 186 186 186 186 186 186 5 5 5 5 6 186
186 1 186 186 186 186 186 186 186 186 186 186 186 186 186 4 5 5 5 70 70 71 23 186
186 186 186 0 1 1 1 2 186 186 186 186 186 186 186 21 70 71 70 70 70 71 23 186
186 186 186 17 70 70 70 71 1 2 186 186 5 186 186 21 70 70 70 70 70 71 23 186
77 78 79 17 70 71 70 70 71 19 79 80 81 82 81 21 70 70 71 70 70 71 23 83
