186 186 17 186 186 186 17 186 186 186 17 186 186 186 17 186 186 186 17 186 186 186 17 186
186 186 17 186 186 186 17 186 186 186 17 186 186 186 17 186 186 186 17 186 186 186 186 186
186 186 17 186 186 186 17 186 186 186 17 186 186 186 17 186 186 186 17 186 186 186 186 186
186 186 17 186 186 186 17 186 186 186 17 186 186 186 17 186 186 186 186 186 186 186 17 186
186 186 17 186 186 186 17 186 186 186 17 186 186 186 17 186 186 186 186 186 186 186 17 186
186 186 17 186 186 186 17 186 186 186 17 186 186 186 186 186 186 186 17 186 186 186 17 186
186 186 17 186 186 186 17 186 186 186 17 186 186 186 186 186 186 186 17 186 186 186 17 186
186 186 17 186 186 186 17 186 186 186 186 186 186 186 17 186 186 186 17 186 186 186 17 186
186 186 17 186 186 186 17 186 186 186 186 186 186 186 17 186 186 186 17 186 186 186 17 186
186 186 17 186 186 186 186 186 186 186 17 186 186 186 17 186 186 186 17 186 186 186 17 186
186 186 17 186 186 186 186 186 186 186 17 186 186 186 17 186 186 186 17 186 186 186 17 186
186 186 186 186 186 186 17 186 186 186 17 186 186 186 17 186 186 186 17 186 186 186 17 186
186 186 186 186 186 186 17 186 186 186 17 186 186 186 17 186 186 186 17 186 186 186 17 186
1 1 17 186 186 186 17 186 186 186 17 186 186 186 17 186 186 186 17 186 186 186 17 186
186 186 17 186 186 186 17 186 186 186 17 186 186 186 17 186 186 186 17 186 186 186 17 186
77 78 17 79 80 81 17 79 80 81 17 79 80 81 17 79 80 81 17 79 80 81 17 82
