35 35 35 35 35 35 35 35 35 35 35 35 35 35 35 35 35 35 35 35 35
186 186 186 186 186 186 186 186 186 186 186 186 186 186 186 186 186 186 186 186 186
186 186 186 186 186 186 186 186 186 186 186 186 186 186 186 186 186 186 186 186 186
186 186 186 186 186 186 186 186 186 186 186 186 186 186 186 186 186 186 186 186 186
186 186 186 186 186 186 186 186 186 186 186 186 186 186 186 186 186 186 186 186 140
186 186 186 186 186 186 186 186 186 186 186 186 186 186 186 186 186 0 1 2 186
186 186 186 186 186 186 186 186 186 186 186 186 186 186 186 0 140 2 17 186 19 186
186 186 186 186 186 186 186 186 186 186 186 186 186 186 17 186 19 17 186 19 186
186 186 186 186 186 186 186 186 186 186 0 1 2 186 17 186 19 17 186 19 186
186 186 186 186 186 186 186 186 1 186 17 186 19 186 17 186 19 17 186 19 186
186 186 186 186 186 186 186 186 186 186 17 186 19 186 17 186 19 17 186 19 186
186 186 186 186 186 0 1 2 186 186 17 186 19 186 17 186 19 17 186 19 186
186 186 186 186 186 17 186 19 186 186 17 186 19 186 17 186 19 17 186 19 186
186 0 1 2 186 17 186 19 186 186 17 186 19 186 17 186 19 17 186 19 186
186 17 186 19 186 17 186 19 186 186 17 186 19 186 17 186 19 17 186 19 186
186 17 186 19 186 17 186 19 186 186 17 186 19 186 17 186 19 17 186 19 186
