186 186 186 186 186 23 35 35 35 35 35 35 35 35 35 35 35 35 35 35 35 35 35 35
186 186 186 186 186 23 186 186 186 186 186 186 9 186 186 186 186 186 186 186 186 186 186 186
38 39 39 39 39 40 186 186 186 186 186 186 26 186 186 186 186 186 186 186 186 186 186 186
186 186 186 186 186 186 186 186 186 186 186 186 186 186 186 186 186 186 186 186 186 186 186 186
186 186 186 186 186 186 186 0 186 186 2 186 186 5 186 186 186 186 186 186 186 186 186 186
186 186 186 186 186 186 186 17 186 186 19 186 186 17 186 186 186 186 186 186 186 186 186 186
186 186 186 186 186 186 186 17 17 17 19 186 186 17 186 186 186 186 186 186 186 186 186 186
186 186 186 186 186 186 186 17 186 186 19 186 186 17 186 186 186 186 186 186 186 186 186 186
186 186 186 186 186 186 186 34 186 186 36 186 186 39 186 186 186 186 186 186 186 186 186 186
186 186 186 186 186 186 186 186 186 186 186 186 186 186 186 186 186 186 186 186 186 186 186 186
186 186 186 186 72 73 186 186 186 186 186 186 186 186 186 186 186 186 186 186 186 186 186 186
186 186 186 186 89 90 186 186 186 186 186 186 186 186 186 186 186 186 186 186 186 186 186 186
186 186 186 186 186 186 186 186 186 186 186 186 186 186 186 186 186 186 186 186 186 186 186 186
186 186 186 186 186 186 186 186 186 186 186 186 186 186 186 186 186 186 186 186 186 186 186 186
1 1 1 1 1 1 1 1 1 1 1 1 1 1 1 1 1 1 1 140 140 1 1 1
77 78 79 80 81 82 83 81 82 83 83 77 78 79 80 81 82 83 77 78 79 80 81 82

