35 35 35 35 35 35 35 35 35 35 35 35 35 35 35 35 35 35 35 35 35 35 35 35
186 186 186 186 186 186 186 186 186 186 186 186 186 186 186 186 186 186 186 186 186 186 186 186
186 186 186 186 186 186 186 0 1 1 1 1 1 2 186 186 186 186 186 186 186 186 186 186
186 186 186 186 186 186 186 17 70 70 70 70 71 19 186 186 186 4 5 5 5 186 186 186
186 186 186 186 186 186 186 17 70 71 71 71 71 19 186 186 186 186 21 186 23 186 186 186
186 186 186 186 186 186 186 17 70 70 71 34 35 36 186 186 186 186 38 39 40 186 186 186
186 186 186 186 186 186 186 17 35 35 35 35 186 186 186 186 186 186 186 186 186 186 186 186
186 186 186 186 186 186 186 186 186 186 186 186 186 186 186 186 186 186 186 186 186 186 186 186
186 186 186 186 186 186 186 186 186 186 186 186 186 186 186 186 186 186 186 186 186 186 186 186
186 186 186 186 186 186 186 186 186 186 186 186 186 186 186 186 186 186 186 186 186 186 186 186
186 186 186 186 186 186 186 186 186 186 186 186 186 186 186 186 186 186 186 186 186 186 186 186
186 186 186 186 186 186 186 186 186 186 186 186 186 186 186 186 186 186 186 186 186 186 186 186
186 186 186 186 186 186 186 186 0 1 1 1 2 186 186 186 186 186 186 186 186 186 186 186
186 186 186 186 186 186 186 186 17 70 70 71 19 186 186 186 186 186 186 186 186 186 186 186
1 1 1 186 186 1 1 1 70 70 70 70 71 1 1 1 1 1 186 186 1 1 1 1
77 77 79 80 81 77 79 80 81 77 77 79 80 81 77 79 80 81 78 79 80 81 82 83
