39 39 39 39 39 39 39 39 39 39 39 39 39 39 39 39 39 39 39 39 39
186 186 186 186 186 186 186 186 186 186 186 186 186 186 186 186 186 12 13 186 186
186 186 186 186 186 186 186 186 186 186 186 186 186 186 186 186 186 186 186 186 186
186 186 186 186 186 186 186 186 186 186 186 186 186 186 186 186 186 186 186 186 186
186 186 186 186 186 186 186 186 186 186 186 186 186 186 186 186 186 186 186 186 186
186 186 186 186 186 186 186 186 186 186 186 186 186 186 186 186 186 186 186 186 186
186 186 186 186 186 186 186 186 186 186 186 186 186 186 186 186 186 186 186 186 186
186 186 186 186 186 186 186 186 186 186 186 186 5 186 186 186 186 5 5 186 186
186 186 186 186 186 186 186 186 186 5 5 186 186 186 5 5 186 186 186 186 186
186 186 186 186 186 186 186 5 186 186 186 186 186 186 186 186 186 186 186 186 186
186 186 186 5 5 186 186 186 186 186 186 5 186 186 186 186 186 186 186 186 186
186 186 186 186 186 186 186 186 186 186 186 186 186 186 186 186 186 186 5 5 140
186 1 186 186 186 186 186 186 186 186 186 186 186 186 186 4 5 5 5 70 70
186 186 186 0 1 1 1 2 186 186 186 186 186 186 186 21 70 71 70 70 70
186 186 186 17 70 70 70 71 1 2 186 186 186 186 186 21 70 70 70 70 70
186 186 186 17 70 71 70 70 71 1 2 186 186 186 186 21 70 70 71 70 70

