186 186 186 19 186 186 186 186 186 186 186 186 186 186 186 186 186 186 186 186 186
186 186 186 19 186 186 186 186 186 186 186 186 186 186 186 186 186 186 186 186 186
186 186 186 19 35 35 35 35 35 35 35 35 35 35 35 35 35 35 35 35 35
38 35 35 40 186 186 186 186 186 186 186 186 186 186 186 186 186 186 186 186 186
186 186 186 186 186 186 186 186 186 186 186 186 186 186 186 186 186 186 186 186 186
186 186 186 186 186 186 186 186 186 186 186 186 186 186 186 186 186 186 186 186 186
186 186 186 186 186 186 186 186 186 186 186 186 186 186 186 186 186 186 186 186 186
186 186 186 186 186 186 186 186 186 186 186 186 186 186 186 186 186 186 186 186 186
186 186 186 186 186 186 186 186 186 186 186 186 186 186 186 186 186 186 186 186 186
186 186 186 186 186 186 186 186 186 186 186 186 186 186 186 186 186 186 186 186 186
186 106 107 186 186 186 186 186 186 186 186 186 186 186 186 186 186 186 186 1 186
186 123 124 186 186 186 186 186 186 186 186 186 186 186 186 186 186 1 1 186 186
186 186 186 186 186 186 186 186 186 186 186 186 186 186 186 186 186 186 186 186 186
1 1 1 1 1 1 1 1 1 1 1 1 1 1 1 2 186 186 186 186 186
70 71 71 71 71 71 70 70 70 70 71 70 71 71 71 71 186 186 186 186 186
70 70 70 70 70 70 71 71 71 71 70 71 70 70 71 71 186 186 186 186 186



