298 299 300 21 186 23 301 21 186 23 301 21 186 23 301 21 186 23 301 21 186 23 303 304
186 186 186 21 186 23 186 21 186 23 186 21 186 23 186 21 186 23 186 21 186 23 186 186
186 186 186 21 186 23 186 21 186 23 186 21 186 23 186 21 186 23 186 21 186 23 186 186
186 186 186 38 39 40 186 21 186 23 186 21 186 23 186 21 186 23 186 21 186 23 186 186
186 186 186 186 186 186 186 38 39 40 186 21 186 23 186 21 186 23 186 21 186 23 186 186
186 186 186 186 186 186 186 186 186 186 186 38 39 40 186 21 186 23 186 21 186 23 186 186
186 186 186 186 186 186 186 186 186 186 186 186 186 186 186 38 39 40 186 21 186 23 186 186
186 186 186 186 373 186 186 186 186 186 186 186 186 186 186 186 186 186 186 38 39 40 186 186
186 186 186 186 186 373 186 186 186 186 186 186 186 186 186 186 186 186 186 186 186 186 186 186
186 186 186 186 186 373 373 186 186 186 186 373 373 373 373 373 373 186 186 186 186 186 186 186
186 186 186 186 186 186 373 373 373 373 373 373 186 186 186 186 186 373 373 373 373 186 186 186
186 186 186 186 186 186 186 186 186 186 186 186 186 186 186 186 186 186 186 186 373 186 186 186
186 186 186 186 186 186 186 186 186 186 186 186 186 186 186 186 186 186 186 186 186 186 186 186
1 1 1 1 1 1 1 1 1 1 1 1 1 1 1 1 1 1 1 1 1 1 1 1
70 70 70 70 70 70 70 70 70 70 70 70 70 70 70 70 70 70 70 70 70 70 70 71
70 70 70 70 70 70 70 70 70 70 70 70 70 70 70 70 70 70 70 70 70 70 70 71
