21 186 23 186 21 186 23 186 21 186 23 186 21 186 23 186 186 21 186 23 186
21 186 23 186 21 186 23 186 21 186 23 186 21 186 23 186 186 21 186 23 186
21 186 23 186 21 186 23 186 21 186 23 186 21 186 23 186 186 21 186 23 186
38 39 40 186 21 186 23 186 21 186 23 186 21 186 23 186 186 21 186 23 186
186 186 186 186 21 186 23 186 21 186 23 186 21 186 23 186 186 21 186 23 186
186 186 186 186 38 39 40 186 21 186 23 186 21 186 23 186 186 21 186 23 186
186 186 186 186 186 186 186 186 38 39 40 186 21 186 23 186 186 21 186 23 186
186 186 186 186 186 186 186 186 186 186 186 186 21 186 23 186 186 21 186 23 186
186 186 186 186 186 186 186 186 186 186 186 186 38 39 40 186 186 21 186 23 186
186 186 186 186 186 186 186 186 186 186 186 186 186 186 186 186 186 38 39 40 186
186 186 186 186 186 186 186 186 186 186 186 186 186 186 186 186 186 186 186 186 186
186 186 186 186 186 186 186 186 186 186 186 186 186 186 186 186 186 186 186 186 186
186 186 186 186 186 186 186 186 186 186 186 186 186 186 186 186 186 186 186 186 186
1 1 1 1 1 1 1 1 1 1 1 1 1 1 1 1 1 1 1 1 186
70 70 70 70 70 70 70 70 70 70 70 70 70 70 70 70 70 70 70 70 186
70 70 70 70 70 70 70 70 70 70 70 70 70 70 70 70 70 70 70 70 186

