186 186 19 35 35 35 35 35 35 35 35 35 35 35 35 35 35 35 35 35 35 35 35 35
186 186 19 186 186 186 186 186 186 186 186 186 186 186 186 186 186 186 186 186 186 186 186 186
35 35 40 186 186 186 186 186 186 186 186 186 186 186 186 186 186 186 186 186 186 186 186 186
186 186 186 186 186 186 186 186 186 186 186 186 186 186 186 186 186 186 186 186 186 186 186 186
186 186 186 186 186 186 186 186 186 186 186 186 186 186 186 186 186 186 186 186 186 186 186 186
186 186 186 186 186 186 186 186 186 186 186 186 186 186 186 186 186 186 186 186 186 186 186 186
186 186 186 186 186 186 186 186 186 186 186 186 186 186 186 186 186 186 186 186 186 186 186 186
186 186 186 186 186 186 186 186 186 186 186 186 186 186 186 186 186 186 186 186 186 186 186 186
186 186 186 186 186 186 186 186 186 186 186 186 186 186 186 186 186 186 0 1 2 186 186 186
186 186 186 186 186 186 186 186 186 186 186 186 186 0 1 2 186 186 17 186 19 186 186 186
186 186 186 186 186 186 186 186 186 186 186 186 186 17 186 19 186 186 17 186 19 186 186 186
186 186 186 186 186 186 186 186 0 1 2 186 186 17 186 19 186 186 17 186 19 186 186 186
186 186 0 1 2 186 186 186 17 186 19 186 186 17 186 19 186 186 17 186 19 186 186 186
186 186 17 186 19 186 186 186 17 186 19 186 186 17 186 19 186 186 17 186 19 186 186 186
186 186 17 186 19 186 186 186 17 186 19 186 186 17 186 19 186 186 17 186 19 186 186 186
77 78 17 186 19 79 80 81 17 186 19 78 79 17 186 19 80 81 17 186 19 81 82 83
