186 186 17 186 186 186 17 186 186 186 17 186 186 186 17 186 186 17 186 186 186
186 186 17 186 186 186 17 186 186 186 17 186 186 186 17 186 186 17 186 186 186
186 186 17 186 186 186 17 186 186 186 17 186 186 186 17 186 186 17 186 186 186
186 186 17 186 186 186 17 186 186 186 17 186 186 186 17 186 186 186 186 186 186
186 186 17 186 186 186 17 186 186 186 17 186 186 186 17 186 186 186 186 186 186
186 186 17 186 186 186 17 186 186 186 17 186 186 186 186 186 186 17 186 186 186
186 186 17 186 186 186 17 186 186 186 17 186 186 186 186 186 186 17 1 186 186
186 186 17 186 186 186 17 186 186 186 186 186 186 186 17 186 186 17 186 1 140
186 186 17 186 186 186 17 186 186 186 186 186 186 186 17 186 186 17 186 186 186
186 186 17 186 186 186 186 186 186 186 17 186 186 186 17 186 186 17 186 186 186
186 186 17 186 186 186 186 186 186 186 17 186 186 186 17 186 186 17 186 186 186
186 186 186 186 186 186 17 186 186 186 17 186 186 186 17 186 186 17 186 186 186
186 186 186 186 186 186 17 186 186 186 17 186 186 186 17 186 186 17 186 186 186
140 1 17 186 186 186 17 186 186 186 17 186 186 186 17 186 186 17 186 186 186
186 186 17 186 186 186 17 186 186 186 17 186 186 186 17 186 186 17 186 186 186
186 186 17 186 186 186 17 186 186 186 17 186 186 186 17 186 186 17 186 186 186

