186 186 19 35 35 35 35 35 35 35 35 35 35 35 35 35 35 35 35 35 35 35 35 35
186 186 19 186 186 186 186 186 186 186 186 186 186 186 186 186 186 186 186 186 186 186 186 186
38 35 40 186 186 186 186 186 186 186 186 186 186 186 186 186 186 186 186 186 186 186 186 186
186 186 186 186 186 186 186 186 186 186 186 186 186 186 186 186 186 186 186 186 186 186 186 186
186 186 186 186 186 186 186 186 186 186 186 186 186 186 186 186 186 186 186 186 186 186 186 186
186 186 186 186 186 186 186 186 186 186 186 186 186 186 186 186 186 186 186 186 186 186 186 186
186 186 186 186 186 186 186 186 186 186 186 186 186 186 186 186 186 186 186 186 186 186 186 186
186 186 186 186 186 186 186 186 186 186 186 186 186 1 1 1 1 1 186 186 186 186 186 186
186 186 186 186 186 186 186 186 186 186 186 186 186 186 186 186 186 186 186 186 186 186 1 186
186 186 186 186 186 186 186 186 186 186 5 186 186 186 186 186 186 186 186 186 186 186 186 186
186 186 186 186 186 186 186 186 186 186 186 186 186 186 186 186 186 186 186 186 186 186 186 186
186 186 186 186 186 186 186 5 5 186 186 186 186 186 5 186 186 5 186 186 186 186 186 186
186 186 186 186 186 5 186 186 186 186 186 186 186 186 186 186 186 186 186 186 186 186 186 186
1 1 186 0 186 186 186 186 186 2 186 186 5 186 186 186 186 186 186 0 1 1 1 1
186 186 186 17 1 1 1 1 1 19 186 186 186 186 186 186 186 186 186 17 87 88 88 88
77 78 79 17 70 70 70 70 71 19 77 78 79 80 81 82 83 82 83 17 87 87 88 88
