222 222 222 222 222 222 222 222 222 222 222 222 222 222 222 222 222 222 222 222 222 222 222 222
186 186 186 186 186 186 186 186 186 186 186 186 186 186 186 186 186 186 186 186 186 186 186 186
186 186 186 186 186 186 186 186 186 186 186 186 186 186 186 186 186 186 186 186 186 186 186 186
186 186 186 186 186 186 186 186 186 186 186 186 186 186 186 186 186 186 186 186 186 186 186 186
186 186 186 186 186 186 186 186 186 186 186 72 73 186 186 186 186 186 186 186 186 186 186 186
186 186 186 186 186 186 186 186 186 186 186 89 90 186 186 186 186 186 186 186 186 186 186 186
186 186 186 186 186 186 186 186 186 186 186 186 186 186 186 186 186 186 186 186 186 186 186 186
186 186 186 186 186 186 186 186 186 186 186 186 186 186 186 186 186 186 186 186 186 186 186 186
186 186 186 186 186 186 186 186 186 186 186 186 186 186 186 186 186 186 186 186 186 186 186 186
186 186 186 186 186 186 186 186 186 186 186 186 186 186 186 186 186 186 186 186 186 186 186 186
186 186 186 186 186 186 186 186 186 186 186 186 186 186 186 186 186 186 186 186 186 186 186 186
186 186 186 186 186 186 186 0 1 1 1 1 1 1 1 1 2 186 186 186 186 186 186 186
186 186 186 186 186 186 186 17 70 70 71 71 71 71 71 71 19 186 186 186 186 186 186 186
186 0 1 1 1 2 186 17 70 70 71 70 70 70 71 71 19 186 0 1 1 1 2 186
186 17 70 71 71 19 186 17 70 71 71 71 71 71 71 71 19 186 17 70 70 71 19 186
78 17 70 71 71 19 79 17 70 70 70 70 70 70 70 71 19 80 17 70 70 71 19 83
