35 35 35 35 35 35 35 35 35 35 35 35 35 35 35 35 35 35 35 35 35
186 186 186 186 186 186 186 186 186 186 186 186 186 186 186 186 186 186 186 186 186
186 186 186 186 186 186 186 186 186 186 186 186 186 186 186 186 186 186 186 186 186
186 186 186 186 186 186 186 186 186 186 186 186 186 186 186 186 186 186 186 186 186
186 186 186 186 186 186 186 186 186 186 186 186 186 186 186 186 186 186 186 186 186
186 186 186 186 186 186 186 186 186 186 186 186 186 186 186 186 186 186 186 186 186
186 186 186 186 186 186 186 186 186 186 186 186 186 186 186 186 186 186 186 186 186
186 186 186 186 186 186 186 186 186 186 186 186 186 186 1 1 1 186 186 186 186
186 186 186 186 186 186 186 186 0 1 1 1 1 1 70 70 71 186 1 186 186
186 186 186 186 186 186 186 186 35 35 35 35 35 35 70 71 71 186 1 186 186
186 186 186 186 186 186 5 186 186 186 186 186 186 186 35 35 35 186 186 186 186
186 186 186 186 186 186 186 186 186 186 186 186 186 186 186 186 186 186 186 186 186
186 186 186 186 5 186 186 186 186 186 186 186 186 186 186 186 186 186 186 186 186
186 0 1 1 1 1 1 1 1 1 1 1 1 1 1 1 186 186 186 1 186
186 21 70 70 70 70 70 70 70 70 70 70 70 70 70 70 186 186 186 70 186
186 21 70 71 70 71 71 71 71 71 71 71 71 71 71 71 186 186 186 71 186

