35 35 35 35 35 35 35 35 35 35 35 9 35 35 35 35 35 9 35 35 35 35 35 9
186 186 186 186 186 186 186 186 186 186 186 26 186 186 186 186 186 26 186 186 186 186 186 26
186 186 186 186 186 186 186 186 186 186 186 186 186 186 186 186 186 186 186 186 186 186 186 186
186 186 186 186 186 186 186 186 186 186 186 186 186 186 186 186 186 186 186 186 186 186 186 186
186 186 186 186 186 186 186 186 186 186 186 186 186 186 186 186 186 186 186 186 186 186 186 186
186 186 186 186 186 186 186 0 1 2 186 186 186 0 1 2 186 186 186 0 1 2 186 186
186 186 186 186 186 186 186 17 186 19 186 186 186 17 186 19 186 186 186 17 186 19 186 186
186 186 186 186 186 1 186 17 186 19 186 186 186 17 186 19 186 186 186 17 186 19 186 186
186 186 186 186 186 186 186 17 186 19 186 186 186 17 186 19 186 186 186 17 186 19 186 186
186 186 186 1 1 186 186 17 186 19 186 186 186 17 186 19 186 186 186 17 186 19 186 186
186 186 186 186 186 186 186 17 186 19 186 186 186 17 186 19 186 186 186 17 186 19 186 186
186 1 1 186 186 186 186 17 186 19 186 186 186 17 186 19 186 186 186 17 186 19 186 186
186 186 186 186 186 186 186 17 186 19 186 186 186 17 186 19 186 186 186 17 186 19 186 186
0 1 1 1 1 1 1 1 1 1 1 1 1 1 1 1 1 1 1 1 1 1 1 2
17 70 70 70 70 70 70 70 70 70 70 70 70 70 70 70 70 70 70 70 70 70 71 19
17 70 71 71 71 71 71 70 70 70 70 70 71 71 70 70 71 71 71 71 70 70 71 19

