111 112 113 21 186 23 113 21 186 23 114 21 186 23 114 21 186 23 114 21 186 23 116 117
186 186 186 21 186 23 186 21 186 23 186 21 186 23 186 21 186 23 186 21 186 23 186 186
186 186 186 21 186 23 186 21 186 23 186 21 186 23 186 21 186 23 186 21 186 23 186 186
186 186 186 38 39 40 186 21 186 23 186 21 186 23 186 21 186 23 186 21 186 23 186 186
186 186 186 186 186 186 186 38 39 40 186 21 186 23 186 21 186 23 186 21 186 23 186 186
186 186 186 186 186 186 186 186 186 186 186 38 39 40 186 21 186 23 186 21 186 23 186 186
186 186 186 186 186 186 186 186 186 186 186 186 186 186 186 38 39 40 186 21 186 23 186 186
186 186 186 186 186 186 186 186 186 186 186 186 186 186 186 186 186 186 186 38 39 40 186 186
186 186 186 186 186 186 186 186 186 186 186 186 186 186 186 186 186 186 186 186 186 186 186 186
186 186 186 186 186 186 186 186 186 186 186 186 186 186 186 186 186 186 186 186 186 186 186 186
186 186 186 186 186 186 186 186 186 186 186 186 186 186 186 186 186 186 186 186 186 186 186 186
186 186 186 186 186 186 186 186 186 186 186 186 186 186 186 186 186 186 186 186 186 186 186 186
186 186 186 186 186 186 186 186 186 186 186 186 186 186 186 186 186 186 186 186 186 186 186 186
1 1 1 1 1 1 1 1 1 1 1 1 1 1 1 1 1 1 1 1 1 1 1 1
70 70 70 70 70 70 70 70 70 70 70 70 70 70 70 70 70 70 70 70 70 70 70 71
70 70 70 70 70 70 70 70 70 70 70 70 70 70 70 70 70 70 70 70 70 70 70 71
