35 35 35 35 35 35 35 35 35 35 35 35 35 35 35 35 35 35 35 35 35
186 186 186 186 186 186 186 186 186 186 186 186 186 186 186 186 186 186 186 186 186
186 186 186 186 186 186 186 186 186 186 186 186 186 186 186 186 186 186 186 186 186
186 186 186 186 186 186 186 186 186 186 186 186 186 186 186 186 186 186 186 186 186
186 186 186 186 186 186 186 186 186 186 186 186 186 186 186 186 186 186 186 186 186
186 186 186 186 186 186 186 186 186 186 186 186 186 186 186 186 186 186 186 186 186
186 186 186 186 186 186 186 186 186 186 186 186 186 186 186 186 186 186 186 186 186
186 186 186 186 186 186 186 186 186 186 186 186 186 186 186 186 186 0 1 1 186
186 186 186 186 186 186 186 186 186 186 186 186 186 186 186 22 1 88 87 88 186
186 186 186 186 186 186 186 186 186 186 186 186 1 140 140 140 87 88 87 88 186
186 186 186 186 186 186 186 186 186 186 186 1 87 88 87 88 87 88 87 88 186
186 186 186 186 186 186 186 186 186 186 1 88 87 88 87 88 87 88 87 88 186
140 186 186 186 186 186 186 186 186 1 87 88 87 88 87 88 87 88 87 88 186
87 1 186 186 186 186 186 186 1 87 87 88 87 88 87 88 87 88 87 88 186
87 87 1 186 186 186 186 1 88 87 87 88 87 88 87 88 87 88 87 88 186
87 87 87 1 186 186 1 87 88 87 87 88 87 88 87 88 87 88 87 88 186


