35 35 35 35 35 35 35 35 35 35 35 35 35 35 35 35 35 35 35 35 35 35 35 35
186 186 186 186 186 186 186 186 186 186 186 186 186 186 186 186 186 186 186 186 186 186 186 186
186 186 186 186 186 186 186 186 186 186 186 186 186 186 186 186 186 186 186 373 373 186 186 186
186 186 186 186 186 186 186 186 186 186 186 186 186 186 186 186 186 186 373 373 373 22 22 22
186 186 186 186 186 186 186 186 186 186 186 186 186 373 373 373 373 373 186 186 22 18 18 18
186 186 186 186 186 186 186 186 186 186 373 373 373 186 186 186 186 186 186 22 18 18 1 1
186 186 186 186 186 186 186 186 186 373 186 186 186 186 186 186 186 22 22 22 1 1 87 87
186 186 186 186 186 186 186 186 186 373 186 186 186 186 186 186 22 1 1 1 87 87 87 87
186 186 186 186 186 186 186 186 373 186 186 186 186 186 186 22 1 87 87 87 87 87 87 186
186 186 186 186 186 186 186 373 373 186 186 186 1 140 140 140 87 87 186 186 186 186 186 186
186 186 186 186 186 186 373 373 186 186 186 1 87 87 87 87 87 186 186 186 186 186 186 186
186 186 186 186 186 373 373 186 186 186 1 87 186 186 186 186 186 186 186 186 186 186 186 186
1 186 186 186 373 186 186 186 186 1 87 186 186 186 186 186 186 186 186 186 186 186 186 186
87 1 186 186 186 186 186 186 1 87 186 186 186 186 186 186 186 186 186 186 186 186 186 186
87 87 1 186 186 186 186 1 87 186 186 186 186 186 186 186 186 186 186 186 186 186 186 186
87 87 87 1 79 80 1 87 87 148 149 150 148 149 150 148 149 150 148 149 150 148 149 150
