18 18 18 19 18 18 18 18 18 18 18 18 18 18 18 18 18 18 18 18 18 18 18 18
18 18 18 19 18 18 18 18 18 18 18 18 18 18 18 18 18 18 18 18 18 18 18 18
18 18 18 19 35 35 35 35 35 35 35 35 35 35 35 35 35 35 35 35 35 35 35 35
38 35 35 40 111 112 113 111 112 113 114 113 115 116 115 116 113 115 116 113 114 115 116 111
186 186 186 186 186 186 186 186 186 186 186 186 186 186 186 186 186 186 186 186 186 186 186 186
186 186 186 186 186 186 186 186 186 186 186 186 186 186 186 186 186 186 186 186 186 186 186 186
186 186 186 186 186 186 186 186 186 186 186 186 186 186 186 186 186 186 186 186 186 186 186 186
186 186 186 186 186 186 186 186 186 186 186 186 186 186 186 186 186 186 186 186 186 186 186 186
186 186 186 186 186 186 186 186 186 186 186 186 186 186 186 186 186 186 186 186 186 186 186 186
186 186 186 186 186 186 186 186 186 186 186 186 186 186 186 186 186 186 186 186 186 186 1 1
186 106 107 186 186 186 186 186 186 186 186 186 186 186 186 186 186 186 186 1 1 1 186 186
186 123 124 186 186 186 186 186 186 186 186 186 186 186 186 186 186 1 1 186 186 186 186 186
186 186 186 186 186 186 186 186 186 186 186 186 186 186 186 186 186 186 186 186 186 186 186 186
1 1 1 1 1 1 1 1 1 1 1 1 1 1 1 1 186 186 186 186 186 186 186 186
70 71 71 71 71 71 70 70 70 70 71 70 71 71 71 71 186 186 186 186 186 186 186 186
70 70 70 70 70 70 71 71 71 71 70 71 70 70 71 71 77 78 79 80 81 77 78 79

